16 16
symbol
################
!..............!
!..............!
!..............!
!..............!
!..........B...!
!..............!
!..............!
!.....AA.......!
!..............!
!..............!
!..............!
!..............!
!..............!
!..............!
################
